empresa;ano;cxEquiv;ctaRecCP;estoque;outAtvCirc;atvCirc;ctaRecLP;investim;Imobilizado;intangivel;outAtvNaoCirc;atvNaoCirc;fornec;dividasCP;outPasCirc;pasCirc;dividasLP;outrPasNaoCirc;pasNaoCirc;patLiq;atvTotal;receitaLiq;custo;despVenda;despAdm;outDespOp;despOper;recFin;despFin;ir_csll;depreciacao;cxAtivOper;cxAtivInvest;cxAtivFinanc
alpha;2018;85458;138707;54674;26318;305157;3885;1204;30153;24342;13998;73582;39909;15938;36892;92739;24441;3755;28196;257804;378739;553290;295729;137328;51052;5651.4;194031.4;14510;22223;9913;14816;42706;26179;-69786
alpha;2019;100637;149828;65053;39893;355411;3769;1093;110205;27198;14511;156776;48914;57342;62145;168401;8176;65220;73396;270390;512188;608587;327460;153798;66689;6614.61;227101.61;8959;15546;15506;29110;74253;-30954;-41418
alpha;2020;203376;217025;105426;41311;567138;929;1093;114633;300759;42016;459430;144673;86793;98849;330315;143078;64417;207495;488757;1026568;576606;302902;192065;58796;7525.83;258386.83;23749;37358;2165;29393;79846;-107741;36767
alpha;2021;95156;286420;163265;51985;596826;1549;1037;146369;367825;106414;623194;208287;180071;162156;550514;13675;78857;92532;576973;1220021;1059651;502003;320527;114603;13053.9;448183.9;15358;38796;21793;38325;87682;-3904;-84630
beta;2018;421335;1381804;335889;223822;2362850;0;64591;682707;68181;616978;1432457;188373;263467;975028;1426868;513191;68831;582022;1786417;3795307;2606735;914589;1130493;298241;42862.02;1471596.02;197954;60612;200553;105547;101021;-134601;162756
beta;2019;568814;1577020;381185;194472;2721491;0;62240;1008870;106919;667876;1845905;229017;297816;1067995;1594828;726197;352879;1079076;1893492;4567396;2829785;1044094;1228732;334842;46907.22;1610481.22;70457;104952;43386;185291;215916;-197250;45223
beta;2020;1224363;1354742;377970;196354;3153429;0;60184;934008;175304;688096;1857592;374609;471845;994815;1841269;1008744;339003;1347747;1822005;5011022;2263442;1117939;842806;371561;36431.01;1250798.01;39938;101245;-62853;189963;503918;-46837;260122
beta;2021;757656;1900299;461206;81982;3201143;0;60140;902397;263977;819600;2046114;379173;499893;1326389;2205455;796431;336587;1133018;1908784;5247258;2617094;1208033;912860;421942;40044.06;1374846.06;57413;130058;-87707;199321;11031;-56812;-387737
gama;2018;365390;743523;1018487;196573;2323973;2743;111792;273355;217024;259220;864134;1487819;47383;417729;1952931;117867;282704;400571;834605;3188108;5650276;4005827;995727;275378;38133.15;1309238.15;48538;155339;68654;59324;448009;-142834;-237629
gama;2019;1722906;1056464;1377831;496682;4653883;6103;110570;1214281;560165;627662;2518781;2150913;3612;745766;2900291;304019;1226676;1530695;2741678;7172665;7207181;5194318;1248212;430757;50369.07;1729338.07;232280;257799;107392;176489;-1206695;-336538;1436919
gama;2020;1052159;1725803;2148144;1162105;6088211;5849;140156;1349531;683883;664989;2844408;3081070;604218;1176980;4862268;7096;1408430;1415526;2654824;8932620;10574346;7848967;1871032;583249;73628.43;2527909.43;66456;215227;8108;254607;943696;-236097;-209046
gama;2021;1494105;2047943;3302441;2038337;8882826;6288;147787;1921441;1560789;1392191;5028496;3660051;147855;1721592;5529498;2314011;1986526;4300537;4081286;13911322;12785479;9709698;2310215;669974;89405.67;3069594.67;178156;427867;-293223;296083;-1581771;-477453;2379905
delta;2018;1344937;1365595;1729826;468247;4908605;78644;39141;525145;517172;1562391;2722493;3135651;1224252;1032895;5392798;370030;953887;1323917;914383;7631099;9759224;6897200;2072675;380540;73596.45;2526811.45;0;0;-43853;120323;304794;-213828;-35880
delta;2019;494339;1852687;1654443;511375;4512844;132645;52550;1815357;451211;1887119;4338882;2637687;1791800;1272454;5701941;346835;2593472;2940307;209478;8851727;9297865;6636620;2016500;337412;70617.36;2424529.36;0;0;-206942;320016;-795873;-179760;125034
delta;2020;1081458;2865648;2238301;790438;6975845;321828;74658;1627987;599078;2380733;5004284;2826507;2423497;1453664;6703668;873067;2236489;3109556;2166904;11980129;10474277;7043617;2135374;322915;73748.67;2532037.67;0;0;-29356;330526;-1529772;-160915;2277804
delta;2021;645468;2500692;2592022;953526;6691708;241008;81544;1818982;776664;3197988;6116186;2808748;1914660;2045495;6768903;1500053;2495981;3996034;2042957;12807895;11198391;7818107;2580787;390325;89133.36;3060245.36;0;0;-457736;359882;405184;-347198;-493978
epsilon;2018;62477;43781;61701;9617;177576;0;0;78921;8360;16321;103602;54566;20066;45462;120094;45975;4441;50416;110667;281179;254332;125082;0;15952;478.56;16430.56;7646;17993;1887;13542;16969;-27182;5476
epsilon;2019;92193;38351;66271;15293;212108;0;0;196186;7446;35568;239200;54673;27769;63724;146166;100113;91687;191800;113341;451308;279016;143180;0;18166;544.98;18710.98;14037;26521;707;33265;31137;-34993;33571
epsilon;2020;109091;49513;56460;15972;231036;0;0;178309;10727;49145;238181;52111;56855;47982;156948;131391;85998;217389;94879;469217;231561;121281;0;19940;598.2;20538.2;19217;42638;-11155;37802;5961;-13050;23985
epsilon;2021;52516;45101;76117;12027;185761;0;0;170435;12957;77118;260510;52307;66203;51298;169808;132251;86067;218318;58144;446271;261625;145491;0;22932;687.96;23619.96;7055;37392;-24000;40100;-12264;-15749;-28563
zeta;2018;161641;414185;177807;42083;795716;0;0;230834;71359;162706;464899;246026;83;388149;634258;586;221660;222246;404111;1260616;1872388;948529;616070;174770;23725.2;814565.2;67478;114836;18814;74377;129940;-89303;-35474
zeta;2019;162040;417319;197415;310329;1087103;0;0;806465;67895;226494;1100854;291389;129706;213528;634623;445699;114762;560461;992872;2187958;1915449;984716;636167;154298;23713.95;814178.95;250210;109250;163100;191617;308740;-116448;-191894
zeta;2020;546948;385557;232317;110885;1275707;0;0;790676;106899;475873;1373448;420012;141560;254491;816063;297420;573522;870942;962150;2649156;1480658;793284;597425;178202;23268.81;798895.81;48689;81827;-32379;200336;219136;-94229;259999
zeta;2021;380631;415091;307791;320576;1424089;0;0;897552;353610;467889;1719051;507653;43917;323692;875262;454346;728083;1182429;1085448;3143140;1867620;998790;734127;176817;27328.32;938272.32;63854;97126;-118881;212007;174248;-207059;-130689
theta;2018;22576;65988;26220;442;115226;17943;55803;60381;9;6637;140773;27292;0;22433;49725;0;25809;25809;180465;255999;167862;80760;55210;14876;2102.58;72188.58;14643;3799;8090;4953;15936;-6472;-34294
theta;2019;25558;67653;29491;11570;134272;25569;58211;89105;11;6167;179063;28026;0;36953;64979;0;35968;35968;212387;313336;174131;81175;55100;22429;2325.87;79854.87;26310;3940;10824;5405;24257;-9051;-12226
theta;2020;65751;62718;30658;1180;160307;2541;68642;84369;619;8532;164703;31793;0;34140;65933;0;29880;29880;229198;325011;163075;75689;42475;27339;2094.42;71908.42;8769;3824;6719;14001;71308;-9691;-21425
theta;2021;12840;107626;43230;27824;191520;2720;85841;108440;800;3803;201604;33695;0;46903;80598;0;41532;41532;270993;393124;222401;103588;52774;22527;2259.03;77560.03;19729;5700;15968;19118;-13058;-16416;-23439
kappa;2018;143784;272139;130941;171461;718325;0;0;81051;42572;304058;427681;177666;134598;186065;498329;233739;61068;294807;352869;1146006;1001773;554455;334575;93083;12829.74;440487.74;147322;48291;190228;49979;30154;-17197;-34993
kappa;2019;262934;316207;160069;121736;860946;0;0;63962;238484;293557;596003;194002;246554;120067;560623;304142;77547;381689;514637;1456949;1044645;562091;249580;90237;10194.51;350011.51;65891;12661;11748;118869;78025;-21732;62855
kappa;2020;190970;255568;99620;101584;647742;0;0;48319;230272;294168;572759;171761;256014;102528;530303;268489;62218;330707;359491;1220502;775365;486078;202846;78743;8447.67;290036.67;9006;60567;-1050;108147;47069;-17089;-101946
kappa;2021;94944;311954;133851;103381;644130;0;0;41021;232563;322913;596497;174378;236069;107882;518329;294144;65908;360052;362246;1240628;915270;487222;234947;83550;9554.91;328051.91;10658;67810;-29407;100101;1615;-44901;-52741
lambda;2018;501720;1146212;402395;98940;2149267;0;0;722826;230163;94660;1047649;346412;516025;704792;1567229;181120;15376;196496;1433191;3196917;3053940;1190372;817837;297181;33450.54;1148468.54;17817;37253;126867;114007;294059;-221009;-115074
lambda;2019;497348;1386601;407542;120847;2412338;0;0;1469128;284221;107864;1861213;392282;324009;1011867;1728158;272180;568170;840350;1705042;4273551;3475033;1352012;919487;319153;37159.2;1275799.2;26971;74738;149592;264599;566406;-271914;-225177
lambda;2020;968512;1381421;500740;373686;3224359;0;0;1396871;340904;344619;2082394;509145;514081;1018430;2041656;712700;558614;1271314;1993782;5306753;2731618;1168283;894457;320825;36458.46;1251740.46;258377;133748;37869;286686;220488;-197095;367239
lambda;2021;2155489;1961732;583335;367797;5068353;0;0;1842918;437671;411172;2691761;638667;755997;1488054;2882718;500547;822741;1323288;3554107;7760114;3831335;1594346;1161450;428043;47684.79;1637177.79;138916;202010;2443;332001;440556;-373225;1173440
sigma;2018;89783;28041;129160;43551;290535;2995;0;84364;698247;267864;1053470;81385;223224;43451;348060;179681;9565;189246;806699;1344005;450902;163734;177777;36935;6441.36;221153.36;4525;56920;9409;27763;33334;-54036;-38014
sigma;2019;173237;33968;112961;40992;361158;2254;0;145386;708084;335753;1191477;115174;236436;64987;416597;300602;8281;308883;827154;1552635;345778;181454;181396;54412;7074.24;242882.24;5674;69638;-25487;63524;25538;-40850;94851
sigma;2020;24443;42702;103037;22012;192194;2404;0;112918;365114;108482;588918;42098;30173;34025;106296;563085;11404;574489;100327;781113;217022;110068;162704;60578;6698.46;229980.46;1640;47164;226077;409267;-117733;-29214;-2006
sigma;2021;16710;57753;83901;24180;182544;3720;0;97741;168899;98503;368863;42344;73454;58566;174364;553814;14486;568300;-191258;551408;317449;151747;160436;43804;6127.2;210367.2;1005;58929;-11971;257627;40486;-31767;-16715
